HttpClient	KEYWORD1

sendGet	KEYWORD2
readResponseCode	KEYWORD2
readLineToChar	KEYWORD2
skipHeaders	KEYWORD2
moveToEOL	KEYWORD2
available	KEYWORD2
waitForResponse	KEYWORD2
httpRead	KEYWORD2
reset	KEYWORD2
setTimeout	KEYWORD2
setDebug	KEYWORD2
connect	KEYWORD2
error	KEYWORD2

print	KEYWORD2
println	KEYWORD2

HTTP_EOF	LITERAL1
HTTP_ERROR	LITERAL1		
HTTP_ERROR_BUFFER_OVERFLOW	LITERAL1
HTTP_ERROR_TIMEOUT	LITERAL1
HTTP_ERROR_CONNECTION_FAILED	LITERAL1
HTTP_DEFAULT_TIMEOUT	LITERAL1
